15 10 10 11 10 10 15 15 15 15 15 15 15 15 15 15 15 15 15 15
15 10 10 11 10 10 15 12 12 12 12 12 12 12 12 12 12 12 12 15
15 15 10 11 10 10 10 10 10 10 10 10 10 10 10 10 10 10 10 10
12 15 10 11 10 11 11 11 10 11 11 11 10 11 11 11 10 11 11 11
12 12 10 11 10 11 10 11 10 11 10 11 10 11 10 11 10 11 10 10
12 12 10 11 10 11 10 11 10 11 10 11 10 11 10 11 10 11 10 15
12 12 10 11 10 11 10 11 10 11 10 11 10 11 10 11 10 11 10 15
12 12 10 11 10 11 10 11 10 11 10 11 10 11 10 11 10 11 10 15
12 12 10 11 10 11 10 11 10 11 10 11 10 11 10 11 10 11 10 15
12 12 10 11 10 11 10 11 10 11 10 11 10 11 10 11 10 11 10 12
12 12 10 11 10 11 10 11 10 11 10 11 10 11 10 11 10 11 10 12
12 12 10 11 10 11 10 11 10 11 10 11 10 11 10 11 10 11 10 12
12 12 10 11 10 11 10 11 10 11 10 11 10 11 10 11 10 11 10 12
12 12 10 11 10 11 10 11 10 11 10 11 10 11 10 11 10 11 10 12
12 12 10 11 10 11 10 11 10 11 10 11 10 11 10 11 10 11 10 12
12 12 10 11 10 11 10 11 10 11 10 11 10 11 10 11 10 11 10 12
12 12 10 11 11 11 10 11 11 11 10 11 11 11 10 11 11 11 10 12
12 12 10 10 10 10 10 10 10 10 10 10 10 10 10 10 10 10 10 12
15 12 12 12 12 12 3 4 5 6 7 8 9 10 12 12 12 12 12 15
15 15 15 15 15 15 0 1 2 16 17 18 19 15 15 15 15 15 15 15