16 10 10 11 10 10 16 15 15 15 15 15 15 15 15 15 15 15 15 16
16 10 10 11 10 10 15 12 12 12 12 12 12 12 12 12 12 12 12 15
16 15 10 11 10 10 10 10 10 10 10 10 10 10 10 10 10 10 10 10
12 15 10 11 10 11 11 11 10 11 11 11 10 11 11 11 10 11 11 11
12 12 10 11 10 11 10 11 10 11 10 11 10 11 10 11 10 11 10 10
12 12 10 11 10 11 10 11 10 11 10 11 10 11 10 11 10 11 10 16
12 12 10 11 10 11 10 11 10 11 10 11 10 11 10 11 10 11 10 16
12 12 10 11 10 11 10 11 10 11 10 11 10 11 10 11 10 11 10 16
12 12 10 11 10 11 10 11 10 11 10 11 10 11 10 11 10 11 10 16
12 12 10 11 10 11 10 11 10 11 10 11 10 11 10 11 10 11 10 12
12 12 10 11 10 11 10 11 10 11 10 11 10 11 10 11 10 11 10 12
12 12 10 11 10 11 10 11 10 11 10 11 10 11 10 11 10 11 10 12
12 12 10 11 10 11 10 11 10 11 10 11 10 11 10 11 10 11 10 12
12 12 10 11 10 11 10 11 10 11 10 11 10 11 10 11 10 11 10 12
12 12 10 11 10 11 10 11 10 11 10 11 10 11 10 11 10 11 10 12
12 12 10 11 10 11 10 11 10 11 10 11 10 11 10 11 10 11 10 12
12 12 10 11 11 11 10 11 11 11 10 11 11 11 10 11 11 11 10 12
12 12 10 10 10 10 10 10 10 10 10 10 10 10 10 10 10 10 10 12
15 12 12 12 12 12 12 12 12 12 12 12 12 12 12 12 12 12 12 15
16 15 15 15 15 15 15 15 15 15 15 15 15 15 15 15 15 15 15 16