12 12 10 11 10 12 12 12 12 12 12 12 12 12 12 12 12 12 12 12
12 12 10 11 10 12 12 12 12 12 12 12 12 12 12 12 12 12 12 12
12 12 10 11 10 10 10 10 10 10 10 10 10 10 10 10 10 10 10 10
12 12 10 11 10 11 11 11 10 11 11 11 10 11 11 11 10 11 11 11
12 12 10 11 10 11 10 11 10 11 10 11 10 11 10 11 10 11 10 10
12 12 10 11 10 11 10 11 10 11 10 11 10 11 10 11 10 11 10 12
12 12 10 11 10 11 10 11 10 11 10 11 10 11 10 11 10 11 10 12
12 12 10 11 10 11 10 11 10 11 10 11 10 11 10 11 10 11 10 12
12 12 10 11 10 11 10 11 10 11 10 11 10 11 10 11 10 11 10 12
12 12 10 11 10 11 10 11 10 11 10 11 10 11 10 11 10 11 10 12
12 12 10 11 10 11 10 11 10 11 10 11 10 11 10 11 10 11 10 12
12 12 10 11 10 11 10 11 10 11 10 11 10 11 10 11 10 11 10 12
12 12 10 11 10 11 10 11 10 11 10 11 10 11 10 11 10 11 10 12
12 12 10 11 10 11 10 11 10 11 10 11 10 11 10 11 10 11 10 12
12 12 10 11 10 11 10 11 10 11 10 11 10 11 10 11 10 11 10 12
12 12 10 11 10 11 10 11 10 11 10 11 10 11 10 11 10 11 10 12
12 12 10 11 11 11 10 11 11 11 10 11 11 11 10 11 11 11 10 12
12 12 10 10 10 10 10 10 10 10 10 10 10 10 10 10 10 10 10 12
12 12 12 12 12 12 12 12 12 12 12 12 12 12 12 12 12 12 12 12
12 12 12 12 12 12 12 12 12 12 12 12 12 12 12 12 12 12 12 12